//MAP CONVERTED BY dmm2tgm.py THIS HEADER COMMENT PREVENTS RECONVERSION, DO NOT REMOVE
"a" = (
/turf/space,
/area/space)
"f" = (
/obj/machinery/atmospherics/binary/pump{
	dir = 8
	},
/turf/simulated/floor/plasteel/white,
/area/space)
"i" = (
/obj/structure/cable{
	d2 = 2;
	icon_state = "0-2";
	color = "#00FF00"
	},
/obj/machinery/power/terminal{
	dir = 4
	},
/turf/simulated/floor/plasteel/white,
/area/space)
"k" = (
/obj/machinery/atmospherics/unary/tank,
/turf/simulated/floor/plasteel/white,
/area/space)
"l" = (
/obj/machinery/bsa/back,
/turf/space,
/area/space)
"o" = (
/obj/machinery/atmospherics/pipe/manifold/hidden,
/turf/simulated/floor/plasteel/white,
/area/space)
"p" = (
/obj/structure/cable{
	d1 = 1;
	d2 = 2;
	icon_state = "1-2";
	color = "#00FF00"
	},
/obj/machinery/atmospherics/pipe/simple/hidden{
	dir = 10
	},
/turf/simulated/floor/plasteel/white,
/area/space)
"q" = (
/obj/machinery/atmospherics/pipe/simple/hidden{
	dir = 4
	},
/turf/simulated/floor/plasteel/white,
/area/space)
"t" = (
/obj/machinery/atmospherics/unary/vent_pump{
	dir = 4
	},
/turf/simulated/floor/plasteel/white,
/area/space)
"u" = (
/obj/machinery/atmospherics/pipe/simple/hidden{
	dir = 5
	},
/turf/simulated/floor/plasteel/white,
/area/space)
"v" = (
/obj/machinery/door/airlock/external/glass,
/obj/effect/mapping_helpers/airlock/access/all/engineering/external,
/turf/space,
/area/space)
"x" = (
/obj/machinery/atmospherics/unary/vent_pump{
	dir = 8
	},
/turf/simulated/floor/plasteel/white,
/area/space)
"z" = (
/obj/effect/spawner/window/shuttle,
/turf/space,
/area/space)
"B" = (
/obj/structure/cable{
	d1 = 1;
	d2 = 2;
	icon_state = "1-2";
	color = "#00FF00"
	},
/obj/machinery/atmospherics/pipe/simple/hidden,
/turf/simulated/floor/plasteel/white,
/area/space)
"D" = (
/turf/simulated/floor/plasteel/white,
/area/space)
"G" = (
/turf/simulated/wall/mineral/titanium,
/area/space)
"I" = (
/obj/structure/shuttle/engine/propulsion{
	dir = 8;
	icon_state = "burst_r"
	},
/turf/simulated/floor/plating/airless,
/area/space)
"K" = (
/obj/structure/cable{
	d2 = 2;
	icon_state = "0-2";
	color = "#00FF00"
	},
/obj/machinery/power/terminal{
	dir = 4
	},
/obj/structure/cable{
	d1 = 1;
	d2 = 2;
	icon_state = "1-2";
	color = "#00FF00"
	},
/turf/simulated/floor/plasteel/white,
/area/space)
"O" = (
/obj/machinery/atmospherics/pipe/manifold/hidden{
	dir = 1
	},
/turf/simulated/floor/plasteel/white,
/area/space)
"Q" = (
/obj/structure/shuttle/engine/heater{
	dir = 8
	},
/turf/simulated/floor/plating/airless,
/area/space)
"T" = (
/obj/machinery/atmospherics/pipe/simple/hidden,
/turf/simulated/floor/plasteel/white,
/area/space)
"Y" = (
/obj/machinery/power/smes,
/turf/simulated/floor/plasteel/white,
/area/space)

(1,1,1) = {"
a
a
a
a
a
a
a
a
a
a
a
a
a
a
a
a
a
a
a
a
a
a
a
a
a
"}
(2,1,1) = {"
a
a
a
a
a
a
a
a
a
a
a
a
a
a
a
a
a
a
a
a
a
a
a
a
a
"}
(3,1,1) = {"
a
a
a
a
a
a
a
a
a
a
a
a
a
a
a
a
a
a
a
a
a
a
a
a
a
"}
(4,1,1) = {"
a
a
a
a
a
a
a
a
a
a
a
a
a
a
G
I
I
G
I
I
G
I
I
G
a
"}
(5,1,1) = {"
a
a
a
a
a
a
a
a
a
a
a
a
a
G
G
Q
Q
G
Q
Q
G
Q
Q
G
G
"}
(6,1,1) = {"
a
a
a
a
a
a
a
a
a
a
a
a
a
G
D
D
D
D
D
D
D
D
D
D
G
"}
(7,1,1) = {"
a
a
a
a
a
a
a
a
a
a
a
a
a
G
D
D
D
D
D
D
D
D
D
D
G
"}
(8,1,1) = {"
a
a
a
a
a
a
a
a
a
a
a
a
a
z
D
D
D
t
D
D
t
D
D
D
z
"}
(9,1,1) = {"
a
a
a
a
a
a
a
a
a
a
a
a
a
z
D
D
D
O
T
T
o
D
D
D
z
"}
(10,1,1) = {"
a
a
a
a
a
a
a
a
a
a
a
a
a
G
D
D
D
q
D
D
f
D
D
D
G
"}
(11,1,1) = {"
a
a
a
a
a
a
a
a
a
a
a
a
a
v
D
D
D
q
D
k
o
D
D
D
v
"}
(12,1,1) = {"
a
a
a
a
a
a
a
a
a
a
a
a
a
G
D
D
D
q
D
D
f
D
D
D
G
"}
(13,1,1) = {"
a
a
a
a
a
a
a
a
a
a
a
a
a
G
D
D
D
q
i
K
p
B
B
B
l
"}
(14,1,1) = {"
a
a
a
a
a
a
a
a
a
a
a
a
a
G
D
D
D
q
Y
Y
D
D
D
D
G
"}
(15,1,1) = {"
a
a
a
a
a
a
a
a
a
a
a
a
a
v
D
D
D
q
D
D
D
D
D
D
v
"}
(16,1,1) = {"
a
a
a
a
a
a
a
a
a
a
a
a
a
G
D
D
D
O
T
T
u
D
D
D
G
"}
(17,1,1) = {"
a
a
a
a
a
a
a
a
a
a
a
a
a
z
D
D
D
x
D
D
x
D
D
D
z
"}
(18,1,1) = {"
a
a
a
a
a
a
a
a
a
a
a
a
a
z
D
D
D
D
D
D
D
D
D
D
z
"}
(19,1,1) = {"
a
a
a
a
a
a
a
a
a
a
a
a
a
G
D
D
D
D
D
D
D
D
D
D
G
"}
(20,1,1) = {"
a
a
a
a
a
a
a
a
a
a
a
a
a
G
G
D
D
D
D
D
D
D
D
G
G
"}
(21,1,1) = {"
a
a
a
a
a
a
a
a
a
a
a
a
a
a
G
G
D
D
D
D
D
D
G
G
a
"}
(22,1,1) = {"
a
a
a
a
a
a
a
a
a
a
a
a
a
a
a
G
G
z
z
z
z
G
G
a
a
"}
(23,1,1) = {"
a
a
a
a
a
a
a
a
a
a
a
a
a
a
a
a
a
a
a
a
a
a
a
a
a
"}
(24,1,1) = {"
a
a
a
a
a
a
a
a
a
a
a
a
a
a
a
a
a
a
a
a
a
a
a
a
a
"}
(25,1,1) = {"
a
a
a
a
a
a
a
a
a
a
a
a
a
a
a
a
a
a
a
a
a
a
a
a
a
"}
